[ 16, 17, 18, 19, 20, 15, 10, 5 ]
[ 16, 17, 18, 19, 14, 15, 10, 5 ]
[ 16, 17, 18, 19, 14, 9, 10, 5 ]
[ 16, 17, 18, 19, 14, 9, 4, 5 ]
[ 16, 17, 18, 19, 14, 9, 5 ]
[ 16, 17, 18, 19, 14, 10, 5 ]
[ 16, 17, 18, 13, 14, 15, 10, 5 ]
[ 16, 17, 18, 13, 14, 9, 10, 5 ]
[ 16, 17, 18, 13, 14, 9, 4, 5 ]
[ 16, 17, 18, 13, 14, 9, 5 ]
[ 16, 17, 18, 13, 14, 10, 5 ]
[ 16, 17, 18, 13, 8, 9, 10, 5 ]
[ 16, 17, 18, 13, 8, 9, 4, 5 ]
[ 16, 17, 18, 13, 8, 9, 5 ]
[ 16, 17, 18, 13, 8, 3, 4, 5 ]
[ 16, 17, 18, 13, 8, 4, 5 ]
[ 16, 17, 18, 13, 9, 10, 5 ]
[ 16, 17, 18, 13, 9, 4, 5 ]
[ 16, 17, 18, 13, 9, 5 ]
[ 16, 17, 18, 14, 15, 10, 5 ]
[ 16, 17, 18, 14, 9, 10, 5 ]
[ 16, 17, 18, 14, 9, 4, 5 ]
[ 16, 17, 18, 14, 9, 5 ]
[ 16, 17, 18, 14, 10, 5 ]
[ 16, 17, 12, 13, 14, 15, 10, 5 ]
[ 16, 17, 12, 13, 14, 9, 10, 5 ]
[ 16, 17, 12, 13, 14, 9, 4, 5 ]
[ 16, 17, 12, 13, 14, 9, 5 ]
[ 16, 17, 12, 13, 14, 10, 5 ]
[ 16, 17, 12, 13, 8, 9, 10, 5 ]
[ 16, 17, 12, 13, 8, 9, 4, 5 ]
[ 16, 17, 12, 13, 8, 9, 5 ]
[ 16, 17, 12, 13, 8, 3, 4, 5 ]
[ 16, 17, 12, 13, 8, 4, 5 ]
[ 16, 17, 12, 13, 9, 10, 5 ]
[ 16, 17, 12, 13, 9, 4, 5 ]
[ 16, 17, 12, 13, 9, 5 ]
[ 16, 17, 12, 7, 8, 9, 10, 5 ]
[ 16, 17, 12, 7, 8, 9, 4, 5 ]
[ 16, 17, 12, 7, 8, 9, 5 ]
[ 16, 17, 12, 7, 8, 3, 4, 5 ]
[ 16, 17, 12, 7, 8, 4, 5 ]
[ 16, 17, 12, 7, 2, 3, 4, 5 ]
[ 16, 17, 12, 7, 3, 4, 5 ]
[ 16, 17, 12, 8, 9, 10, 5 ]
[ 16, 17, 12, 8, 9, 4, 5 ]
[ 16, 17, 12, 8, 9, 5 ]
[ 16, 17, 12, 8, 3, 4, 5 ]
[ 16, 17, 12, 8, 4, 5 ]
[ 16, 17, 13, 14, 15, 10, 5 ]
[ 16, 17, 13, 14, 9, 10, 5 ]
[ 16, 17, 13, 14, 9, 4, 5 ]
[ 16, 17, 13, 14, 9, 5 ]
[ 16, 17, 13, 14, 10, 5 ]
[ 16, 17, 13, 8, 9, 10, 5 ]
[ 16, 17, 13, 8, 9, 4, 5 ]
[ 16, 17, 13, 8, 9, 5 ]
[ 16, 17, 13, 8, 3, 4, 5 ]
[ 16, 17, 13, 8, 4, 5 ]
[ 16, 17, 13, 9, 10, 5 ]
[ 16, 17, 13, 9, 4, 5 ]
[ 16, 17, 13, 9, 5 ]
[ 16, 11, 12, 13, 14, 15, 10, 5 ]
[ 16, 11, 12, 13, 14, 9, 10, 5 ]
[ 16, 11, 12, 13, 14, 9, 4, 5 ]
[ 16, 11, 12, 13, 14, 9, 5 ]
[ 16, 11, 12, 13, 14, 10, 5 ]
[ 16, 11, 12, 13, 8, 9, 10, 5 ]
[ 16, 11, 12, 13, 8, 9, 4, 5 ]
[ 16, 11, 12, 13, 8, 9, 5 ]
[ 16, 11, 12, 13, 8, 3, 4, 5 ]
[ 16, 11, 12, 13, 8, 4, 5 ]
[ 16, 11, 12, 13, 9, 10, 5 ]
[ 16, 11, 12, 13, 9, 4, 5 ]
[ 16, 11, 12, 13, 9, 5 ]
[ 16, 11, 12, 7, 8, 9, 10, 5 ]
[ 16, 11, 12, 7, 8, 9, 4, 5 ]
[ 16, 11, 12, 7, 8, 9, 5 ]
[ 16, 11, 12, 7, 8, 3, 4, 5 ]
[ 16, 11, 12, 7, 8, 4, 5 ]
[ 16, 11, 12, 7, 2, 3, 4, 5 ]
[ 16, 11, 12, 7, 3, 4, 5 ]
[ 16, 11, 12, 8, 9, 10, 5 ]
[ 16, 11, 12, 8, 9, 4, 5 ]
[ 16, 11, 12, 8, 9, 5 ]
[ 16, 11, 12, 8, 3, 4, 5 ]
[ 16, 11, 12, 8, 4, 5 ]
[ 16, 11, 6, 7, 8, 9, 10, 5 ]
[ 16, 11, 6, 7, 8, 9, 4, 5 ]
[ 16, 11, 6, 7, 8, 9, 5 ]
[ 16, 11, 6, 7, 8, 3, 4, 5 ]
[ 16, 11, 6, 7, 8, 4, 5 ]
[ 16, 11, 6, 7, 2, 3, 4, 5 ]
[ 16, 11, 6, 7, 3, 4, 5 ]
[ 16, 11, 6, 1, 2, 3, 4, 5 ]
[ 16, 11, 6, 2, 3, 4, 5 ]
[ 16, 11, 7, 8, 9, 10, 5 ]
[ 16, 11, 7, 8, 9, 4, 5 ]
[ 16, 11, 7, 8, 9, 5 ]
[ 16, 11, 7, 8, 3, 4, 5 ]
[ 16, 11, 7, 8, 4, 5 ]
[ 16, 11, 7, 2, 3, 4, 5 ]
[ 16, 11, 7, 3, 4, 5 ]
[ 16, 12, 13, 14, 15, 10, 5 ]
[ 16, 12, 13, 14, 9, 10, 5 ]
[ 16, 12, 13, 14, 9, 4, 5 ]
[ 16, 12, 13, 14, 9, 5 ]
[ 16, 12, 13, 14, 10, 5 ]
[ 16, 12, 13, 8, 9, 10, 5 ]
[ 16, 12, 13, 8, 9, 4, 5 ]
[ 16, 12, 13, 8, 9, 5 ]
[ 16, 12, 13, 8, 3, 4, 5 ]
[ 16, 12, 13, 8, 4, 5 ]
[ 16, 12, 13, 9, 10, 5 ]
[ 16, 12, 13, 9, 4, 5 ]
[ 16, 12, 13, 9, 5 ]
[ 16, 12, 7, 8, 9, 10, 5 ]
[ 16, 12, 7, 8, 9, 4, 5 ]
[ 16, 12, 7, 8, 9, 5 ]
[ 16, 12, 7, 8, 3, 4, 5 ]
[ 16, 12, 7, 8, 4, 5 ]
[ 16, 12, 7, 2, 3, 4, 5 ]
[ 16, 12, 7, 3, 4, 5 ]
[ 16, 12, 8, 9, 10, 5 ]
[ 16, 12, 8, 9, 4, 5 ]
[ 16, 12, 8, 9, 5 ]
[ 16, 12, 8, 3, 4, 5 ]
[ 16, 12, 8, 4, 5 ]
Paths:  128
